111111 11111
100001 10001
101111110001
100000000101
100001110101
1000111N0111
100110010111
100111000101
100000000001
111111111111
